"","group","index","negative","positive","sentiment"
"1",25,15,4361,4045,-316
"2",25,16,5225,4307,-918
"3",25,17,4268,3599,-669
"4",25,18,3940,3507,-433
"5",25,19,3319,2852,-467
"6",25,20,3798,2876,-922
"7",25,21,1456,1268,-188
"8",25,23,1,0,-1
"9",27,2,1,0,-1
"10",27,12,42,34,-8
