"","group","index","negative","positive","sentiment"
"1",1,15,0,2,2
"2",1,21,1,0,-1
"3",2,0,2,0,-2
"4",3,9,1,0,-1
"5",3,14,2,1,-1
"6",4,17,6,3,-3
"7",5,6,3,1,-2
"8",5,16,1,0,-1
"9",5,20,1,0,-1
"10",6,0,1,0,-1
"11",6,1,4,1,-3
"12",6,14,3,13,10
"13",6,21,0,1,1
"14",6,22,0,1,1
"15",7,5,2,1,-1
"16",7,15,2,1,-1
"17",8,2,0,2,2
"18",8,3,2,0,-2
"19",8,6,4,2,-2
"20",8,9,3,2,-1
"21",8,11,2,1,-1
"22",8,12,2,2,0
"23",8,13,3,5,2
"24",8,16,1,1,0
"25",8,17,2,8,6
"26",8,18,1,7,6
"27",8,20,0,6,6
"28",8,21,3,1,-2
"29",8,22,1,3,2
"30",9,0,0,1,1
"31",9,1,2,0,-2
"32",9,4,1,0,-1
"33",9,5,3,0,-3
"34",9,7,2,2,0
"35",9,8,3,1,-2
"36",9,9,4,2,-2
"37",9,10,3,1,-2
"38",9,11,2,0,-2
"39",9,12,1,0,-1
"40",9,13,2,0,-2
"41",9,14,0,1,1
"42",9,15,6,9,3
"43",9,16,1,2,1
"44",9,17,0,1,1
"45",9,18,1,3,2
"46",9,20,1,1,0
"47",9,21,3,0,-3
"48",9,22,9,1,-8
"49",9,23,5,1,-4
"50",10,0,8,8,0
"51",10,1,5,1,-4
"52",10,3,11,1,-10
"53",10,5,5,3,-2
"54",10,6,3,2,-1
"55",10,7,5,0,-5
"56",10,8,4,2,-2
"57",10,10,1,0,-1
"58",10,11,0,3,3
"59",10,12,6,1,-5
"60",10,13,1,1,0
"61",10,14,26,49,23
"62",10,15,2,0,-2
"63",10,16,4,7,3
"64",10,17,4,4,0
"65",10,18,5,7,2
"66",10,19,20,8,-12
"67",10,20,3,2,-1
"68",10,21,4,19,15
"69",10,22,4,10,6
"70",10,23,13,3,-10
"71",11,0,11,1,-10
"72",11,1,7,11,4
"73",11,2,676,254,-422
"74",11,3,422,184,-238
"75",12,14,2,0,-2
"76",13,15,1,1,0
"77",15,13,1,1,0
"78",16,0,1,0,-1
"79",16,5,2,0,-2
"80",16,6,1,2,1
"81",16,12,0,1,1
"82",16,15,3,0,-3
"83",16,17,1,0,-1
"84",17,0,1,0,-1
"85",17,1,2,0,-2
"86",17,4,1,1,0
"87",17,10,1,0,-1
"88",17,14,0,1,1
"89",17,17,0,1,1
"90",17,22,3,0,-3
"91",19,2,1,1,0
"92",19,4,0,1,1
"93",19,13,2,1,-1
"94",20,2,0,1,1
"95",20,5,0,1,1
"96",20,6,2,0,-2
"97",20,22,1,1,0
"98",21,6,0,1,1
"99",21,13,1,0,-1
"100",21,20,1,2,1
"101",22,11,0,1,1
"102",22,15,0,1,1
"103",22,18,0,2,2
"104",23,3,1,0,-1
"105",23,16,0,2,2
"106",23,17,0,1,1
"107",23,21,2,2,0
"108",23,22,1,0,-1
"109",24,16,2,1,-1
"110",24,18,1,2,1
"111",24,20,0,1,1
"112",24,22,0,1,1
"113",24,23,1,1,0
"114",25,3,1,2,1
"115",25,4,1,0,-1
"116",25,5,2,1,-1
"117",25,6,2,0,-2
"118",25,7,2,0,-2
"119",25,9,1,0,-1
"120",25,11,1,0,-1
"121",25,12,1,0,-1
"122",25,16,0,1,1
"123",25,17,1,3,2
"124",25,18,2,2,0
"125",25,19,2,1,-1
"126",25,20,3,1,-2
"127",25,21,2,0,-2
"128",25,23,1,0,-1
"129",26,1,1,0,-1
"130",26,2,1,0,-1
"131",26,3,1,1,0
"132",26,4,3,1,-2
"133",26,5,0,2,2
"134",26,6,0,1,1
"135",26,9,1,0,-1
"136",26,11,1,3,2
"137",26,12,2,0,-2
"138",26,13,0,1,1
"139",26,14,2,1,-1
"140",26,15,1,3,2
"141",26,16,5,5,0
"142",26,17,14,3,-11
"143",26,18,1,0,-1
"144",26,19,6,2,-4
"145",26,20,12,10,-2
"146",26,21,12,8,-4
"147",26,22,7,6,-1
"148",26,23,3,4,1
"149",27,0,12,2,-10
"150",27,1,8,4,-4
"151",27,2,3,5,2
"152",27,3,23,7,-16
"153",27,4,347,151,-196
"154",27,5,602,247,-355
"155",27,6,349,145,-204
"156",27,7,293,161,-132
"157",27,8,360,254,-106
"158",27,9,56,21,-35
"159",27,11,1,0,-1
"160",27,12,0,2,2
"161",27,13,1,0,-1
"162",27,14,0,5,5
"163",27,15,2,0,-2
"164",27,16,1,0,-1
"165",27,17,1,0,-1
"166",27,19,2,1,-1
"167",27,20,2,1,-1
"168",27,22,5,0,-5
"169",27,23,2,1,-1
"170",28,0,69,88,19
"171",28,1,101,120,19
"172",28,5,2,1,-1
"173",28,17,0,1,1
"174",28,18,2,1,-1
"175",28,20,0,2,2
"176",28,21,0,1,1
"177",28,22,2,0,-2
"178",28,23,2,4,2
"179",29,0,6,3,-3
"180",29,1,137,94,-43
"181",29,4,1,1,0
"182",29,5,2,0,-2
"183",29,7,1,0,-1
"184",29,8,1,0,-1
"185",29,9,0,2,2
"186",29,10,1,0,-1
"187",29,12,0,3,3
"188",29,13,1,2,1
"189",29,14,1,0,-1
"190",29,15,0,4,4
"191",29,16,0,4,4
"192",29,18,4,3,-1
"193",29,19,3,0,-3
"194",29,20,2,0,-2
"195",29,21,0,1,1
"196",29,22,4,4,0
"197",29,23,3,1,-2
"198",30,0,71,53,-18
"199",30,1,97,85,-12
"200",30,5,2,0,-2
"201",30,6,2,1,-1
"202",30,7,1,0,-1
"203",30,10,0,1,1
"204",30,11,6,0,-6
"205",30,12,0,1,1
"206",30,15,2,0,-2
"207",30,17,7,4,-3
"208",30,18,2,2,0
"209",30,19,5,3,-2
"210",30,20,2,3,1
"211",30,21,3,8,5
"212",30,22,3,3,0
"213",30,23,4,9,5
"214",31,0,275,267,-8
"215",31,1,87,151,64
